de                        833
y                         503
la                        490
que                       461
el                        409
en                        366
a                         267
se                        158
del                       153
su                        148
los                       138
un                        137
con                       133
al                        126
las                       120
mi                        112
por                       103
una                       96
no                        95
me                        89
